0000000000
1010110101
0011100111
0100001000
0000000000
0000000000
1010110101
0011100111
0100001000
0000000000
